Disarm=Disarm
Unlocking Cantrip=UnlockingCantrip
Unseen Force=UnseenForce
Spatial Distortion=SpatialDistortion
Teleportation=Teleportation
Sense alignment=SenseAlignment
See Contents=SeeContents
Read Aura=ReadAura
Sense Hidden=SenseHidden
Divine Magic=DivineMagic
vitality of air=VitalityOfAir
poison vapours=PoisonVapours
call winds=CallWinds
body of air=BodyOfAir
call air elemental=CallAirElemental
Strength of earth=StrengthOfEarth
stone throw=StoneThrow
wall of stone=WallOfStone
body of stone=BodyOfStone
call earth elemental=CallEarthElemental
agility of fire=AgilityOfFire
wall of fire=WallOfFire
fireflash=FireFlash
body of fire=BodyOfFire
call of fire=CallOfFire
purity of water=PurityOfWater
call fog=CallFog
squall of ice=SquallOfIce
body of water=BodyOfWater
call water elemental=CallWaterElemental
shield protection=ShieldProtection
jolt=Jolt
wall of force=WallOfForce
bolt of lightning=BoltOfLightning
disintegrate=Disintegrate
charm=Charm
stun=Stun
drain will=DrainWill
nightmare=Nightmare
dominate will=DominateWill
resist magick=ResistMagick
disperse magick=DisperseMagick
dweomer shield=DweomerShield
bonds of magick=BondsOfMagick
reflection shield=ReflectionShield
hardened hands=HardenedHands
weaken=Weaken
shrink=Shrink
flesh to stone=FleshToStone
polymorph=Polymorph
charm beast=CharmBeast
entangle=Entangle
control beast=ControlBeast
succour beast=SuccourBeast
regenerate=Regenerate
harm=Harm
conjure spirit=ConjureSpirit
summon undead=SummonUndead
create undead=CreateUndead
quench life=QuenchLife
minor healing=MinorHealing
halt poison=HaltPoison
major healing=MajorHealing
sanctuary=Sanctuary
resurrect=Resurrect
illuminate=Illuminate
flash=Flash
blur sight=BlurSight
phantasmal fiend=PhantasmalFiend
invisibility=Invisibility
plague of insects=PlagueOfInsects
orcish champion=OrcishChampion
guardian ogre=GuardianOgre
hellgate=Hellgate
familiar=Familiar
magelock=Magelock
congeal time=CongealTime
hasten=Hasten
stasis=Stasis
tempus fugit=TempusFugit