Apprenticed to a Blacksmith=ApprenticedToABlacksmith
Apprenticed to a Shopkeeper=ApprenticedToAShopkeeper
Beat with an Ugly Stick=BeatWithAnUglyStick
Born Under a Sign=BornUnderASign
Child of a Hero=ChildOfAHero
Dark Sight=DarkSight
Educator=Educator
Extreme Personality=ExtremePersonality
Hyperactive=Hyperactive
Inheritance=Inheritance
Mad Doctor=MadDoctor
Miracle Operation=MiracleOperation
Nietzsche Poster Child=NietzschePosterChild
Only Child=OnlyChild
Professional Knife Tosser=ProfessionalKnifeTosser
Raised by Monks=RaisedByMonks
Raised by Snake Handlers=RaisedBySnakeHandlers
Raised in the Pits=RaisedInThePits
Ran Away with the Circus=RanAwayWithTheCircus
Sickly=Sickly
Sold Your Soul=SoldYourSoul
Special Person=SpecialPerson
Troll Offspring=TrollOffspring
Afraid of the Dark=AfraidOfTheDark
Agoraphobic=Agoraphobic
Army Training=ArmyTraining
Arsonist=Arsonist
Bandit=Bandit
Barbarian=Barbarian
Bookworm=Bookworm
Bride of Frankenstein=BrideOfFrankenstein
Bully=Bully
Charlatan's Protégé=CharlatansProtege
Clanless Dwarf=ClanlessDwarf
Dark Elf Follower=DarkElfFollower
Day Mage=DayMage
Disenfranchised Gnome=DisenfranchisedGnome
Elven Blood=ElvenBlood
Escaped Lunatic=EscapedLunatic
Factory Escapee=FactoryEscapee
Feral Child=FeralChild
Foppish Elf=FoppishElf
Frankenstein Monster=FrankensteinMonster
Freed Bodyguard=FreedBodyguard
Halfling Orphan=HalflingOrphan
Hydrophobic=Hydrophobic
Idiot Savant=IdiotSavant
Lady's Man=LadysMan
Magick Allergy=MagickAllergy
Nature Mage=NatureMage
Night Mage=NightMage
Raised By Elves=RaisedByElves
Raised By Orcs=RaisedByOrcs
Rare Half-Ogre Birth=RareHalfOgreBirth
Sent to Charm School=SentToCharmSchool
Sheltered Childhood=ShelteredChildhood
Sky Mage=SkyMage
Super Model=SuperModel
Suppressed Orcish Looks=SuppressedOrcishLooks
Technophobia=Technophobia
Tomboy=Tomboy
Tough Hide=ToughHide
Wild Half-Ogre=WildHalfOgre