healing salve=HealingSalve
fatigue restorer=FatigueRestorer
poison cure=PoisonCure
fatigue limiter=FatigueLimiter
accelerate healing=AccelerateHealing
wonder drug=WonderDrug
cure all=CureAll
strong poison=StrongPoison
charges=Charges
animal scent=AnimalScent
corrosive acid=CorrosiveAcid
hallucinate=Hallucinate
paralyzer=Paralyzer
anaesthisizer=Anaesthisizer
electric light=ElectricLight
charged ring=ChargedRing
flow spectrometer=FlowSpectrometer
shocking staff=ShockingTraffic
chapeu of magnetic inversion=ChapeuOfMagneticInversion
healing jacket=HealingJacket
tesla rod=TeslaRod
molotov cocktail=MolotovCocktail
flash grenade=FlashGrenade
smoke grenade=SmokeGrenade
stun grenade=StunGrenade
explosive grenade=ExplosiveGrenade
fire obstruction=FireObstruction
dynamite=Dynamite
hand crafted flintlock=HandCraftFlintlock
fine revolver=FineRevolver
repeater rifle=RepeaterRifle
hushed revolver=HushedRevolver
looking glass rifle=LookingGlassRifle
hand cannon=HandCannon
elephant gun=ElephantGun
spike trap=SpikeTrap
trap springer=TrapSpringer
auto skeleton key=AutoSkeletonKey
eye gear=EyeGear
bear trap=BearTrap
clockwork decoy=ClockworDecoy
mechanized arachnid=MechanizedArachnid
pure ore=PureOre
balanced sword=BalancedSword
feather-weight axe=FeatherWeightAxe
dwarven gauntlets=DwarvenGauntlets
helmet of vision=HelmetOfVision
feather-weight chainmail=FeatherWeightChainmail
elite platemail=ElitePlatemail
elixir of persuasion=ElixirOfPersuasion
elixir of physical prowess=ElixirOfPhysicalProwess
liquid of awareness=LiquidOfAwareness
tonic of increased reflexes=TonicOfIncreasedReflexes
mind marvel=MindMarvel
energizer=Energizer
revitalizer=Revitalizer